[
  {
    "type": "mapgen",
    "method": "json",
    "om_terrain": [ "field_highway_youkai" ],
    "weight": 1000,
    "object": {
      "rows": [
        ",,,,,,.,,,,.,,,,,,,.,,,,",
        ",,,.,,,,.,,,,.,..,,,,,,,",
        ",,,,,,,..,,,,,,,,..,,,,.",
        ",,,,,,,,,,,,,,..,,,,,,,,",
        ",,,,,,,.,,,,..,,,,..,,,,",
        ",,,..,,,,,,,,,,,..,,,,..",
        ",,,,,,,,,,..,,,,.,,,,,,,",
        ",,,..,,,,,,,,..,,,,,,,,.",
        ",,,,,,,..,,,,.,,,,,,,,..",
        ",,,..,,,,,,,,,,,,,,,,,,.",
        "..,,,,,,,,.,,,,.,,,,,,,.",
        ",,,,,,,,,,,,,,,,,,.,,,,.",
        ",,,.,,,,,,,,,,,,,,,,,,,.",
        ",,,..,,,,,,,,..,,,,,,,,.",
        ",,,,..,,,,..,,,,..,,,,..",
        ",,,.,,,,,,,,,,,,,,,.,,,,",
        ",,,,,,,..,,,,.,,,,.,,,,.",
        ",,,..,,,,.,,,,..,,,,,,,,",
        ",,,..,,,,,,,,,,,,..,,,,.",
        "..,,,,..,,,,,,,,,,,.,,,,",
        ",,,..,..,,,,.,..,,,,,,,.",
        ",,,,,,.,,,,.,,,,,,,,,,,.",
        ",,,..,,,,,,,,,,,,,,,,,,.",
        ",,,.,,,,.,,,,,,,,,,,,,,,"
      ],
      "terrain": { ",": "t_grass", ".": "t_dirt" },
      "place_monsters": [ { "monster": "GROUP_YOUKAI_THUGS", "x": [ 4, 16 ], "y": [ 4, 16 ], "density": 0.1 } ]
    }
  },
  {
    "type": "mapgen",
    "method": "json",
    "om_terrain": [ "ruined_kami_shrine" ],
    "weight": 250,
    "object": {
      "rows": [
        ",,,,,,.,,,,.,,,,,,,.,,,,",
        ",,,.,,,,.,,,,.,..,,,,,,,",
        ",,,,,,,..,,,,,,,,..,,,,.",
        ",,,,,,,,,,,,,,..,,,,,,,,",
        ",,,,,,,.,,,,..,,,,..,,,,",
        ",,,..,,,,,,,,,,,..,,,,..",
        ",,,,,,,,,,..,,,,.,,,,,,,",
        ",,,..,,,,,,,,..,,,,,,,,.",
        ",,,,,,,.........,,,,,,..",
        ",,,..,,,.dwWwwd.,,,,,,,.",
        "..,,,,,,.w####w.,,,,,,,.",
        ",,,,,,,,.w####W.,,.,,,,.",
        ",,,.,,,,.W++++d.,,,,,,,.",
        ",,,..,,,.dwDDwd.,,,,,,,.",
        ",,,,..,,.++++++...,,,,..",
        ",,,.,,,,.|++++|.,,,.,,,,",
        ",,,,,,,..,,..,,,,,.,,,,.",
        ",,,..,,,,.H..H..,,,,,,,,",
        ",,,..,,,,,.,.,,,,..,,,,.",
        "..,,,,..,,,.,,,,,,,.,,,,",
        ",,,..,..,,,,....,,,,,,,.",
        ",,,,,,.,,,,..,,,,,,,,,,.",
        ",,,..,,,,,,...,,,,,,,,,.",
        ",,,.,,,,.,.,..,,,,,,,,,,"
      ],
      "terrain": { 
		",": "t_grass", 
		".": "t_dirt", 
		"D": "t_door_c", 
		"w": "t_wall_log_chipped", 
		"W": "t_wall_log", 
		"d": "t_wall_log_broken", 
		"|": "t_pillar",
		"#": "t_floor",
		"+": "t_floor",
		"H": "t_hashira"
	  },
	  "furniture": {
		"#": "f_tatami"
	  },
      "place_npcs": [ { "class": "tesuto", "x": [12], "y": [12] } ]
    }
  },
  {
    "type": "mapgen",
    "method": "json",
    "om_terrain": [ "ruined_kami_shrine_roof" ],
    "weight": 250,
    "object": {
	  "fill_ter": "t_open_air",
	  "rows": [
        "                        ",
        "                        ",
        "                        ",
        "                        ",
        "                        ",
        "                        ",
        "                        ",
        "                        ",
        "        rrrrrrrr        ",
        "        rrrrrrrr        ",
        "        rrrrrrrr        ",
        "        rrrrrrrr        ",
        "        rrrrrrrr        ",
        "        rrrrrrrr        ",
        "        rrrrrrrr        ",
        "        rrrrrrrr        ",
        "                        ",
        "                        ",
        "                        ",
        "                        ",
        "                        ",
        "                        ",
        "                        ",
        "                        "
      ],
      "terrain": { "r": "t_wood_treated_roof" }
    }
  },
  {
    "type": "mapgen",
    "method": "json",
    "om_terrain": [ "kami_shrine" ],
    "weight": 50,
    "object": {
      "rows": [
        ",,,,,,.,,,,.,,,,,,,.,,,,",
        ",,,.,,,,.,,,,.,..,,,,,,,",
        ",,,,,,,..,,,,,,,,..,,,,.",
        ",,,,,,,,,,,,,,..,,,,,,,,",
        ",,,,,,,.,,,,..,,,,..,,,,",
        ",,,..,,,,,,,,,,,..,,,,..",
        ",,,,,,,,,,..,,,,.,,,,,,,",
        ",,,..,,,,,,,,..,,,,,,,,.",
        ",,,,,,,.++++++++,,,,,,..",
        ",,,..,,,+WWWWWW+,,,,,,,.",
        "..,,,,,,+W####W+,,,,,,,.",
        ",,,,,,,,+W####W+,,.,,,,.",
        ",,,.,,,,+W++++W+,,,,,,,.",
        ",,,..,,,+WWDDWW+,,,,,,,.",
        ",,,,..,,++++++++..,,,,..",
        ",,,.,,,,+|++++|+,,,.,,,,",
        ",,,,,,,..,,...,,,,.,,,,.",
        ",,,..,,,,.H..H..,,,,,,,,",
        ",,,..,,,,,...,,,,..,,,,.",
        "..,,,,..,,,..,,,,,,.,,,,",
        ",,,..,..,,,.....,,,,,,,.",
        ",,,,,,.,,,,..,,,,,,,,,,.",
        ",,,..,,,,,,...,,,,,,,,,.",
        ",,,.,,,,.,....,,,,,,,,,,"
      ],
      "terrain": { 
	    ",": "t_grass",
		".": "t_dirt",
		"D": "t_door_c",
		"W": "t_wall_log",
		"|": "t_pillar",
		"+": "t_floor",
		"#": "t_floor",
		"H": "t_hashira"
	  },
	  "furniture": {
		"#": "f_tatami"
	  },
      "place_npcs": [ { "class": "tesuto", "x": [12], "y": [12] } ]
    }
  },
  {
    "type": "mapgen",
    "method": "json",
    "om_terrain": [ "kami_shrine_roof" ],
    "weight": 50,
    "object": {
	  "fill_ter": "t_open_air",
      "rows": [
        "                        ",
        "                        ",
        "                        ",
        "                        ",
        "                        ",
        "                        ",
        "                        ",
        "                        ",
        "        rrrrrrrr        ",
        "        rrrrrrrr        ",
        "        rrrrrrrr        ",
        "        rrrrrrrr        ",
        "        rrrrrrrr        ",
        "        rrrrrrrr        ",
        "        rrrrrrrr        ",
        "        rrrrrrrr        ",
        "                        ",
        "                        ",
        "                        ",
        "                        ",
        "                        ",
        "                        ",
        "                        ",
        "                        "
      ],
      "terrain": { "r": "t_wood_treated_roof" }
    }
  }
]
